++++++++++
++  ++    
+  +    ++
++  + ++ +
 + ++ +  +
++S   + ++
 + + ++ + 
++++++++++
